"#############"
"#           #"
"#   ### ### #"
"#   #     # #"
"##### ### # #"
"#   #     # #"
"#   ### ### #"
"#           #"
"#     #######"
"#           #"
"######      #"
"#           #" 
"#############"



"#############"
"#   #       #"
"#   #       #"
"#   #       #"
"## ##  # #  #"
"#   #  # #  #"
"#   ######  #"
"#   #    #  #"
"#   ### ##  #"
"#           #"
"#####       #"
"#           #"
"#############"


"#############"
"#           #"
"#   #   #   #"
"# ##### # ###"
"#   #   #   #"
"### # ##### #"
"#   #   #   #"
"# ##### # ###"
"#   #   #   #"
"#   #   #   #"
"#           #"
"#           #"
"#############"



"#############"
"# ######### #"
"#           #"
"# ### ### # #"
"# #     #   #"
"# # ##### # #"
"#   #   #   #"
"# ### ### # #"
"# #       # #"
"#   #   #   #"
"# ######### #"
"#           #"
"#############"



"#############"
"# #       # #"
"# # ##### # #"
"# #     # # #"
"# ##### # # #"
"#     # # # #"
"##### # # # #"
"#     # #   #"
"##### ##### #"
"#         # #"
"# ######### #"
"#           #"
"#############"



"#############"
"#           #"
"# #### #### #"
"# #       # #"
"# # ##### # #"
"# #       # #"
"#   # # #   #"
"# #       # #"
"# # ##### # #"
"# #       # #"
"# #### #### #"
"#           #"
"#############"



"#############"
"#           #"
"# ######### #"
"# #       # #"
"# # ##### # #"
"# #     # # #"
"# ##### # # #"
"#       # # #"
"# ##### # # #"
"# #     # # #"
"# # ##### # #"
"# #       # #"
"#############"



"#############"
"#           #"
"# ######### #"
"# #       # #"
"# # ##### # #"
"# #     # # #"
"# #####   # #"
"#       #####"
"# #     # # #"
"# # ##### # #"
"# #       # #"
"# ######### #"
"#############"



"#############"
"#           #"
"# ######### #"
"# #       # #"
"# # ##### # #"
"# #     # # #"
"# #####   # #"
"#         ###"
"# ###     # #"
"#   #     # #"
"#####       #"
"#           #"
"#############"



"#############"
"#     #     #"
"#     #     #"
"# ######### #"
"#           #"
"# #####     #"
"#   #####   #"
"#     ##### #"
"#           #"
"# ######### #"
"#     #     #"
"#     #     #"
"#############"



"#############"
"#           #"
"#           #"
"# ###########"
"#           #"
"# #### ##   #"
"#   #   #   #"
"#   ## ##   #"
"#   #   #   #"
"###### ######"
"#        #  #"
"#           #"
"#############"



"#############"
"#           #"
"#     #     #"
"#  ######## #"
"# #####     #"
"#   #####   #"
"#     ##### #"
"#   #####   #"
"# #######   #"
"#  ######## #"
"#     #     #"
"#           #"
"#############"



"#############"
"#           #"
"#     #     #"
"# ######### #"
"#     #     #"
"# ##### #####" 
"#     #     #"
"# ##### #####"
"#     #     #"
"# ######### #"
"#     #     #"
"#     #     #"
"#############"



"#############"
"#     #     #"
"#           #"
"# ######### #"
"#     ##### #"
"# #####     #"
"#   #####   #"
"#     ##### #"
"#   #   #   #"
"#   #   #   #"
"#   #   #   #"
"#           #"
"#############"
